#################
#p    m         #
# c             #
#  c  m         #
#   c           #
#     m         #
#              c#
#             cd#
#################
nn
##################
#ccc#p           #
###c##           #
##ccc#           #
#cc###           #
#c####           #
#ccccc         d #
##################
nn
##################
#p ##cccccccccccc#
# ###c##c#c#c#c#c#
#    ##c#c#c#c##c#
###m             #
########  m#######
#######    c######
####m        m####
###            ###
##c#c#c#c##c#c#c##
######## #########
#      # #       #
#######   ########
#    #     #     #
#####       ######
#  m         m   #
###           ####
#c              d#
##################
nn
##################
################p#
#cc              #
#c#############m #
#                #
# ##############m#
#                #
################ #
#c#c#c#c#c#c#c#c #
#                #
#c#c#c#c#c#c#c#cd#
##################
nn
##################
#p      ccccccccc#
#       ccccccccc#
#       ccccccccc#
#       ccccccccc#
#       ccccccccc#
#       ccccccccc#
#mm m   ccccccccc#
#m  mm  ccccccccc#
#d mmm  ccccccccc#
##################
nn
