#  p #mcm
#   c#mcm
##    dcm
#   c#mcm
#   c#mcm
#   c#mcm
#   c#mcm
ccccccccm
mmmmmmmmm
