#  p #mc
#   c#mc
####  dc
#   c#mc
#   c#mc
#   c#mc
#   c#mc
cccccccc
